-'s	của
-ation	hoá
-elect	tân cử
-er	hơn
-est	nhất
-fold	gấp
-gon	giác
-hood	thời
-ification	hoá
-ify	hoá
-ism	chủ nghĩa
-ization	hoá
-ize	hoá
-land	nước
-less	cây đinh không
-logy	học
-ness	sự
-ology	học
-pedia	-pedia
-s	những
-ship	mối
-th	thứ
-ty	mươi
101	nhập môn
24/7	24/7
